am	AEP
is	S-
are	R-
was	WAS
were	WER
being	PWAOEG
been	PWAOEUPB
have	-F
has	HAS
had	HAD
having	HAFG
do	DO
does	DAOEZ
did	DEUD
doing	DOEPBG
done	DOPB
can	K
could	KUD
will	HR
would	WUD
shall	SHAL
should	SHUD
may	PHAEU
might	PHAOEUT
must	PHUFT
