will	HR
would	WUD
can	K
could	KUD
shall	SHAL
should	SHUD
must	PHUFT
may	PHAEU
might	PHAOEUT
need	TPHAOED
needs	TPHAOEDZ
needed	TPHAOETD
want	WAUPBT
wants	WAUPBTS
wanted	WAUPBTD
what	WHA
when	WH
where	W-R
which	KH
who	HO
whom	WHOM
whose	WHOZ
why	KWH
how	HOU
