am	APL
is	S
are	R
was	WAS
were	WR
being	-BG
been	PW-PB
have	SR
has	HAS
had	H
having	SR-G
do	TKO
does	TKOS
did	TK
doing	TKO*G
done	TKOPB
can	K
could	KUD
will	HR
would	WUD
shall	SHAL
should	SHUD
may	PHAEU
might	PHAOEUT
must	PHUFT
