day	TKAEU
time	TAOEUPL
year	KWHAOER
man	PHAPB
men	PHEPB
people	P
mother	PHO*RT
father	TPA*URT
boy	PWOEU
house	HOUS
home	HOEPL
hand	HAPBD
water	WAU/TER
world	WORLD
word	WORD
part	PART
place	PHRAEUS
picture	PEUBG/KHUR
number	TPHUPL/PWER
name	TPHAEUPL