again	TKPWEPB
back	PWABG
down	TKOUPB
each	AOEFP
even	AOEFPB
every	EFR
first	TPEUFRT
here	HAOER
like	HRAOEUBG
near	TPHAOER
now	TPHOU
off	AUF
one	WUPB
other	OER
out	AOUT
round	ROUPBD
same	SAEUPL
self	SEFL
such	SUFP
than	THAPB