the	-T
a	AEU
an	APB
and	SKP
or	AUR
but	PWUT
so	SO
if	TP
then	THEPB
that	THA
this	TH
these	THAOES
there	THR
some	SOPL
any	TPHEU
all	AUL
much	PHUFP
many	PHA*EPB
more	PHOR
most	PHOEFT
very	SRE
also	HR-S
just	SKWRUFT
only	OEPBL